非卖品	出售品
干巴巴	湿漉漉
高材生	低能儿
高个儿	矮个儿
高个子	矮个子
工业国	农业国
公费生	自费生
公有林	私有林
公有制	私有制
挂一�	包罗万象
喝倒采	捧场
合成词	单纯词
合法性	非法性
黑沉沉	白茫茫
黑道日	黄道日
黑洞洞	亮堂堂
黑呼呼	黑洞洞
黑忽忽	白茫茫
黑糊糊	亮堂堂
黑脸儿	白脸儿
黑压压	白茫茫
黑黝黝	红彤彤
横剖面	纵剖面
横坐标	纵坐标
後半晌	前半晌
後段班	前段班
黄道日	黑道日
灰溜溜	气冲冲
活火山	死火山
活扣儿	死扣儿
急巴巴	慢腾腾
急匆匆	慢腾腾
急性子	慢性子
加害人	被害人
交流电	直流电
交战国	参战国
阶下囚	座上宾
禁不起	禁得起
禁不住	禁得起
禁得起	禁不起
禁得住	禁得起
精灵鬼	戆小子
精装本	平装本
静悄悄	闹哄哄
局外人	当事人
窭人子	富家儿
军用品	民用品
君主国	共和国
开场白	压轴戏
开卷考	闭卷考
开幕词	闭幕词
开幕式	闭幕式
看不起	看得起
看得起	看不起
空荡荡	满登登
口头语	书面语
哭咧咧	哭啼啼
哭啼啼	哭咧咧
苦咧咧	甜津津
苦日子	好日子
快车道	慢车道
快动作	慢动作
宽绰绰	窄巴巴
来不及	来得及
来得及	来不及
来路货	本国货
劳动者	剥削者
老搭档	新伙伴
老豆腐	嫩豆腐
乐陶陶	笑嘻嘻
冷冰冰	热乎乎
冷门货	热门货
冷清清	冷冰冰
冷丝丝	暖烘烘
冷飕飕	热烘烘
离心力	向心力
连记法	单记法
凉丝丝	暖烘烘
两点论	一点论
亮堂堂	黑洞洞
零售商	批发商
笼中鸟	脱�马
楼底下	楼顶
沦落户	破落户
卖国贼	爱国者
满登登	空荡荡
慢车道	快车道
慢动作	快动作
慢腾腾	急匆匆
没信心	有把握
民用品	军用品
民主国	共和国
目的地	出发点
南寒带	北寒带
南极光	北极光
南极圈	北极圈
南温带	北温带
闹哄哄	静悄悄
偶然性	必然性
气呼呼	兴冲冲
麻麻黑	麻麻亮
麻麻亮	麻麻黑
慢吞吞	慢腾腾
慢性子	急性子
慢悠悠	慢腾腾
美男子	美女
蒙蒙亮	麻麻黑
明晃晃	白茫茫
明面上	暗地里
拿不住	拿得住
拿得住	拿不住
男傧相	女傧相
南半球	北半球
南方人	北方人
闹嚷嚷	静悄悄
嫩豆腐	老豆腐
凝固点	溶解点
农业国	工业国
怒冲冲	喜孜孜
女傧相	男傧相
暖和和	冷冰冰
暖烘烘	冷丝丝
跑龙套	唱主角
配角儿	主角儿
碰钉子	一帆风顺
批发商	零售商
平装本	精装本
破落户	沦落户
普遍性	特殊性
骑墙式	一面倒
气冲冲	哭啼啼
前半晌	後半晌
前段班	後段班
乾巴巴	湿漉漉
轻飘飘	沉甸甸
轻轻的	重重的
清一色	大杂烩
群言堂	一言堂
绕远儿	抄近儿
绕指柔	百链钢
惹是非	守规矩
热烘烘	冷飕飕
热乎乎	冷冰冰
热呼呼	冷冰冰
热门货	冷门货
热腾腾	冷冰冰
人造林	天然林
溶解点	凝固点
肉中刺	掌上珠
入射线	反射线
软骨头	硬骨头
软绵绵	硬梆梆
三春晖	寸草心
上半晌	下半晌
上等货	珍贵品
上水道	下水道
奢侈品	必需品
生产者	消费者
生石灰	熟石灰
湿漉漉	干巴巴
事实审	法律审
守财奴	败家子
守规矩	惹是非
受话器	发话器
书面语	口头语
熟石灰	生石灰
私有林	公有林
私有制	公有制
死火山	活火山
死扣儿	活扣儿
死亡率	出生率
速决战	持久战
袒处之	局促不安
袒自若	周章狼狈
特殊性	普遍性
天才者	高材生
天然林	人造林
甜津津	苦咧咧
甜丝丝	苦咧咧
同盟者	反对者
投射角	反射角
凸面镜	凹面镜
凸透镜	凹透镜
土博士	洋博士
推斥力	吸引力
脱缰马	笼中鸟
脱�马	出柙虎
唯物论	唯心论
唯心论	唯物论
文言文	语体文
无神论	有神论
西半球	东半球
西洋画	中国画
下水道	上水道
下意识	有意识
下战书	上昼
香馥馥	香喷喷
向光性	背光性
向心力	离心力
雄赳赳	软绵绵
矮矬子	长人
矮笃笃	高挑儿
矮墩墩	高挑儿
矮个儿	长人
矮脚虎	伟丈夫
爱面子	丢脸
拗口令	顺口溜
拔尖儿	平常
白皑皑	暗沉沉
白撞雨	毛毛雨
摆摊子	收摊儿
败家精	亢宗子
保护国	独立国
保守派	革命派
本主儿	别人
闭幕词	开幕词
辩证法	形而上学
不服气	服劲
不择食	挑肥拣瘦
大家庭	小家庭
干乎乎	稀溜溜
高八斗	才疏学浅
老搭当	新伙伴
乱无章	错落有致
无意识	有意识
吸引力	推斥力
稀溜溜	干乎乎
喜孜孜	怒冲冲
下半晌	上半晌
咸水湖	淡水湖
咸水鱼	淡水鱼
香喷喷	香馥馥
想不通	想得通
想得通	想不通
消费者	生产者
消极性	积极性
小老婆	大老婆
笑嘻嘻	乐陶陶
新伙伴	老搭当
兴冲冲	灰溜溜
刑警队	侦缉队
选修科	必修科
压轴戏	开场白
阳关道	独木桥
洋博士	土博士
一点论	两点论
一会儿	好一阵
一面倒	骑墙式
一年生	多年生
一神教	多神教
一言堂	群言堂
一元论	多元论
义务兵	志愿兵
迎风面	背风面
迎风坡	背风坡
硬邦邦	软绵绵
硬梆梆	软绵绵
硬绑绑	软绵绵
硬骨头	软骨头
优越感	自卑感
游击队	正规军
有把握	没信心
有关系	妨碍
有神论	无神论
有意识	无意识
语体文	文言文
辕下驹	出笼鸟
杂牌儿	正牌儿
杂牌军	正规军
在野党	执政党
灶下婢	掌上珠
窄巴巴	宽绰绰
战败国	战胜国
战胜国	战败国
站住脚	站不住脚
掌上珠	肉中刺
侦缉队	刑警队
珍贵品	上等货
真老虎	纸老虎
正比例	反比例
正规军	游击队
正牌儿	杂牌儿
执政党	在野党
直流电	交流电
殖民地	附庸国
纸老虎	真老虎
志愿兵	义务兵
中国画	西洋画
中立国	交战国
重沉沉	沉甸甸
重重的	轻轻的
自卑感	优越感
自费生	公费生
自然人	法人
自由民	奴隶
自由诗	格律诗
纵剖面	横剖面
纵坐标	横坐标
座上宾	阶下囚
座上客	阶下囚
暗沉沉	白皑皑
白灿灿	黑油油
白苍苍	红扑扑
白糊糊	暗沉沉
白话诗	格律诗
白话文	文言文
白净净	黑黪黪
白蒙蒙	暗沉沉
白煞煞	红扑扑
白刷刷	红扑扑
白天鹅	丑小鸭
半辈子	百年
半天空	大地
帮倒忙	敲边鼓
傍边儿	离开
爆性子	好性儿
悲切切	
悲切切	乐颠颠
悲切切	怒冲冲
背包袱	放包袱
背饥荒	
背饥荒	贷款
背饥荒	还款
背饥荒	讨债
背靠背	面对面
被动性	主动性
本地人	他乡人
本乡人	他乡人
笨家伙	聪明人
比不上	比得上
比得上	比不上
便宜货	上等货
表面上	骨子里
瘪塌塌	鼓绷绷
不打紧	打紧
不大离	差得多
不得劲	得劲
不动产	动产
不害臊	脸皮薄
不害羞	脸皮薄
不济事	抵事
不济事	不赖
不见得	包管
不离儿	不济
不舍得	不惜
不失为	算不上
不一定	包管
不则声	出声
不值当	值当
不做声	出声
擦黑儿	拔白
擦亮儿	挨黑
彩色片	黑白片
残疾人	常人
草底儿	定稿
差不多	差得多
差不离	差得多
差得多	不大离
拆墙脚	补台
唱白脸	唱红脸
唱红脸	唱白脸
抄近路	绕道
抄小路	绕道
潮呼呼	干巴巴
成总儿	零散
吃不开	吃得开
吃得开	吃不开
吃老本	立新功
充其量	起码
冲盹儿	醒盹儿
抽抽儿	饱满
丑八怪	娥眉
丑小鸭	白天鹅
臭乎乎	香馥馥
臭熏熏	香馥馥
出门子	娶妻
出生率	死亡率
处理品	上等货
传统戏	文明戏
瓷公鸡	小孟尝
次等品	上等货
聪明人	笨家伙
打晃儿	站稳
大前儿	大后儿
大前年	大后年
大前天	大后儿
大人物	小人物
当家子	外家
倒霉鬼	幸运儿
倒仰儿	前趴儿
等外品	上等货
东道主	宾客
短命鬼	老寿星
放包袱	背包袱
附属国	独立国
跟得住	比不上
鼓溜溜	瘪塌塌
鼓腾腾	瘪塌塌
固定工	合同工
立新功	吃老本
打伙儿	拆伙
打零工	打长工
打零活	打长工
打头阵	压后阵
大多数	极少数
大个儿	矮矬子
大个子	矮矬子
大后儿	大前儿
大后方	敌前
大后年	大前年
大后天	大前儿
大有年	常年
大有年	常年
大有年	旱年
单个儿	比肩
单行本	合订本
单一色	大杂烩
抵不上	比得上
抵得上	比不上
店小二	财东
店小二	财东
店小二	顾客
对抗赛	友谊赛
对口词	多口词
多方面	单方面
二百五	聪明人
发源地	入海口
藩属国	独立国
反动派	革命派
犯不上	不妨
犯不上	犯得上
犯不着	不妨
犯不着	犯得上
肥墩墩	瘦刮刮
肥溜溜	瘦刮刮
肥油油	瘦刮刮
盖然性	必然性
赶不及	赶得及
赶不上	赶得及
赶得及	不遑
赶得上	不遑
赶任务	磨洋工
赶趟儿	不遑
高挑儿	矮笃笃
革命派	保守派
革新派	保守派
跟趟儿	不遑
公开信	匿名信
鼓绷绷	瘪塌塌
雇佣兵	义务兵
归道山	出生
鬼点子	高招
国产货	舶来品
寒丝丝	暖烘烘
好性儿	爆性子
好意思	脸皮薄
合订本	单行本
合同工	固定工
黑魃魃	白皑皑
黑白片	彩色片
黑黪黪	白净净
黑茫茫	白皑皑
黑蒙蒙	白皑皑
黑漆漆	白皑皑
黑黢黢	白皑皑
红扑扑	白苍苍
红润润	白苍苍
后半晌	前半晌
后半天	前半天
后半夜	前半夜
后个儿	前个儿
糊涂虫	聪明人
糊涂蛋	聪明人
活死人	聪明人
或然性	必然性
机灵鬼	笨家伙
极少数	大多数
寄生虫	寄主
架不住	比得上
健康人	残废
交运	背时
结束语	开场白
今体诗	古体诗
近体诗	古体诗
局中人	当局者迷
局中人	当局者迷
局中人	第三者
开头语	结束语
扛长活	打短工
亢宗子	败家精
靠不住	靠得住
抠门儿	大方
乐颠颠	悲切切
乐颠颠	悲切切
乐颠颠	怒冲冲
雷暴雨	毛毛雨
雷阵雨	毛毛雨
冷请清	乱哄哄
冷森森	暖烘烘
女公子	息女
兢业业	玩忽职守
空落落	满登登
懒洋洋	气昂昂
老大娘	老大爷
老大爷	老大娘
老公公	老婆婆
老年间	现而今
老婆儿	老头儿
老婆婆	老公公
老婆子	老头子
老寿星	短命鬼
老头儿	老婆儿
老头子	老婆子
老一辈	下一代
脸皮薄	不害臊
脸皮厚	脸皮薄
撂挑子	挑担子
临时工	固定工
灵活性	原则性
乱纷纷	齐刷刷
乱哄哄	静悄悄
乱麻麻	齐刷刷
乱蓬蓬	齐刷刷
乱腾腾	齐刷刷
乱糟糟	齐刷刷
馒悠悠	急巴巴
毛毛雨	白撞雨
铆劲儿	松劲
冒尖儿	平常
没空儿	得空
没性子	爆性子
猛孤丁	渐次
米粮川	不毛之地
眯盹儿	醒盹儿
密麻麻	稀拉拉
密匝匝	稀拉拉
面对面	背靠背
磨洋工	赶任务
末班车	头班车
内行星	外行星
那程子	这程子
难为情	不害臊
匿名信	公开信
牛毛雨	白撞雨
暖乎乎	寒丝丝
暖融融	寒丝丝
盘陀路	直道
旁观者	旁观者清当事人
旁观者	当局者迷
旁观者	当局者迷
旁观者	当局者迷
旁观者	当局者迷
胖鼓鼓	瘦刮刮
胖乎乎	瘦刮刮
胖激激	瘦刮刮
贫骨头	小孟尝
平阳地	高山
仆从国	独立国
齐刷刷	乱纷纷
齐整整	乱纷纷
起点站	终点站
千里马	劣马
前半天	后半天
前半夜	后半夜
前趴儿	倒仰儿
抢手货	冷门货
轻工业	重工业
轻泡货	重货
绕口令	顺口溜
人行道	车道
肉乎乎	瘦刮刮
入海口	发源地
三岔路	直道
三寸丁	伟丈夫
嫂夫人	贱内
上半天	后半天
上半夜	后半夜
上等品	处理品
上坡路	下坡路
舍不得	不惜
始发站	终点站
收摊儿	摆摊子
守旧派	革命派
守钱虏	小孟尝
瘦棱棱	肥墩墩
瘦嶙嶙	肥墩墩
瘦伶仃	肥墩墩
瘦伶伶	肥墩墩
瘦溜溜	肥墩墩
顺口溜	拗口令
四方步	碎步儿
算不上	不失为
缩写本	繁本
他乡人	本地人
铁仙鹤	小孟尝
挖墙脚	补台
歪点子	高招
现如今	老年间
一小撮	大多数
宗主国	保护国
矮胖子	侉大个儿
成文法	习惯法
打圆场	搬弄是非
大姑娘	小伙子
简化字	繁体字
死胡同	出路
馊主意	高招
讨便宜	吃亏
讨老婆	出阁
特殊化	一般化
剔庄货	上等货
挑担子	撂挑子
铁公鸡	小孟尝
铁汉子	软骨头
铁算盘	小孟尝
头班车	末班车
土产品	舶来品
外地人	本地人
外流河	内流河
外乡人	本地人
外行星	内行星
伟丈夫	矮脚虎
未定稿	定稿
未知数	已知数
文明戏	传统戏
窝囊废	聪明人
窝囊废	铁汉子
乌油油	白灿灿
无须乎	必得
稀拉拉	密麻麻
媳妇儿	汉子
细溜溜	矮笃笃
下半天	前半天
下半响	上半晌
下半夜	前半夜
下等品	上等货
下黑儿	拔白
下脚货	上等货
下坡路	上坡路
下一代	老一辈
现代戏	传统戏
现而今	老年间
小夫人	正房
小家庭	大家庭
小孟尝	瓷公鸡
小气鬼	小孟尝
小气货	小孟尝
小人物	大人物
笑呵呵	哭咧咧
笑眯眯	哭咧咧
笑盈盈	哭咧咧
卸包袱	背包袱
新一代	老一辈
兴奋剂	镇静剂
醒盹儿	冲盹儿
幸运儿	倒霉鬼
压后阵	打头阵
眼中钉	掌中珠
一般化	特殊化
一般性	特殊性
一辈子	半辈子
一点儿	大量
姨太太	正房
已知数	未知数
异体字	正体
异乡人	本地人
硬汉子	软骨头
友谊赛	对抗赛
有盼儿	绝望
原则性	灵活性
躁性子	好性儿
占便宜	吃亏
丈夫气	脂粉气
折子戏	本戏
这程子	那程子
真嗓子	假嗓子
镇静剂	兴奋剂
正常人	残废
正式工	合同工
之字路	直道
直溜溜	曲曲弯弯
值不当	值当
智多星	笨家伙
滞销货	抢手货
终点站	起点站
重工业	轻工业
皱巴巴	笔挺
主动性	被动性
主权国	保护国
专门家	门外汉
庄园主	佃户
滋补品	毒品
滋养品	毒品
自发性	被动性
自豪感	自卑感
自觉性	被动性
尊夫人	贱内
坐班房	出狱
坐班房	出狱
坐班房	越狱
安乐窝	栖身所
白唰唰	红朴朴
摆摊儿	收摊儿
保育院	敬老院
背地里	表面上
本噪子	假噪子
不相遇	打照面
常备军	后备军
出土品	传世品
触眉头	走八字
触楣头	走八字
传世品	出土品
垂直线	平行线
打边鼓	帮倒忙
打长工	打短工
打长工	打短儿
打短工	打长工
当间儿	两边
当间儿	笨鸟先飞
当着面	暗地里
点头交	金石交
丢面子	爱面子
动肝火	息怒
短粗胖	细高挑儿
多而杂	少而精
多口词	对口词
多面手	单面手
发射点	弹着点
繁体字	简化宇
干活儿	喘气
赶浪头	反潮流
公诉人	自诉人
骨子里	表面上
鼓涨涨	播塌塌
观赏鱼	食用鱼
黑森森	亮晃晃
黑腾腾	亮晃晃
黑��	亮晃晃
黑油油	白灿灿
后备军	常备军
后来人	先驱者
慌神儿	沉住气
机动车	人力车
基础课	专业课
急冲冲	慢腾腾
既成品	半成品
继起者	先驱者
寄宿生	通读生
假嗓子	本噪子
揭盖子	捂盖子
紧巴巴	充裕
锦标赛	友谊赛
敬老院	保育院
静幽幽	乱哄哄
君主制	共和制
开快车	磨洋工
看财奴	败家精
扛大活	打短儿
扣帽子	摘帽子
苦唧唧	甜不丝儿
苦森森	甜不丝儿
苦丝丝	甜不丝儿
苦味儿	甜味儿
苦英英	甜不丝儿
拉肚子	便闭
老脸皮	抹不开
老前辈	后生
乐呵呵	气氛氛
泪澜澜	泪汪汪
泪汪汪	泪澜澜
冷嗦嗦	暖烘烘
凉冰冰	暖烘烘
凉津津	暖烘烘
凉飕飕	暖烘烘
两回事	一回事
两码事	一回事
亮晃晃	黑沉沉
亮闪闪	黑沉沉
亮锃锃	黑沉沉
劣等生	高材生
留两手	露两手
留一手	露一手
露两手	留两手
露一手	留一手
沦落人	暴发户
落地户	外来户
满堂灌	启发式
慢郎中	急性子
慢性病	暴病
没骨头	铁汉子
蒙松雨	白撞雨
面团团	侉大个儿
明灿灿	黑沉沉
明光光	黑沉沉
明闪闪	黑沉沉
明堂堂	黑沉沉
匿名书	公开信
凝聚力	推斥力
日西斜	日东升
枢门儿	大方
当间儿	大失所望
摸亮儿	擦黑儿
摸明儿	擦黑儿
抹不开	不害躁
内行人	门外汉
闹肚子	便闭
暖呼呼	冷冰冰
暖洋洋	冷冰冰
胖嘟嘟	瘦刮刮
胖墩墩	瘦刮刮
胖墩儿	搓板
拼老命	耍滑头
平川地	高山
气氛氛	乐颠颠
气哼哼	乐颠颠
气囔囔	乐颠颠
敲边鼓	帮倒忙
敲竹杠	饮马投钱
翘尾巴	夹尾巴
清白吏	贪官污吏
请进来	走出去
全日制	半日制
绕道儿	抄近儿
热辣辣	冷冰冰
日西下	日东升
软乎乎	硬邦邦
软溜溜	硬邦邦
三贫路	直道
闪击战	持久战
上辈子	下辈子
上等生	劣等生
少而精	多而杂
生死交	半面之交
湿乎乎	干巴巴
湿渌渌	干巴巴
食用鱼	观赏鱼
受损失	讨便宜
兽力车	人力车
瘦刮刮	肥墩墩
瘦筋筋	肥墩墩
瘦精精	肥墩墩
耍滑头	拼老命
四周围	当中间儿
酸溜溜	甜不丝儿
随大溜	赶浪头
随风倒	赶浪头
随风转	赶浪头
甜乎乎	苦唧唧
甜溜溜	苦唧唧
甜蜜蜜	苦唧唧
甜滋滋	苦唧唧
通读生	寄宿生
通学生	寄宿生
顽固派	革命派
万不耐	不舞之鹤
忘年交	半面之交
乌沉沉	亮晃晃
乌洞洞	亮晃晃
无需乎	必须
捂盖子	揭盖子
西药房	中药店
稀乎乎	干乎乎
喜冲冲	怒冲冲
喜吟吟	怒冲冲
喜盈盈	怒冲冲
先驱者	后来人
先行者	后来人
小矮子	大个儿
小伙子	大姑娘
笑乎乎	哭啼啼
羞答答	不害臊
言声儿	不则声
眼底下	老年间
仰八叉	狗吃屎
一大堆	不丁点儿
一大批	不丁点儿
一回事	两回事
一些儿	大批
一阵儿	半天
一阵子	半天
硬绷绷	软乎乎
硬撅撅	软乎乎
有点儿	大为
有分寸	敞开儿
有会儿	一忽儿
有限度	敞开儿
有主见	随大溜
曰将暝	日东升
摘帽子	戴帽子
掌柜的	伙计
掌中珠	肉中刺
争面子	丢面子
正当中	大失所望
值个儿	不值当
值过儿	不值当
指挥员	战斗员
住读生	通读生
住校生	通读生
子公司	总公司
自己人	局外人
好性子	爆性子
红朴朴	白苍苍
假噪子	本噪子
栖身所	安乐窝
添麻烦	帮助
养老院	保育院
总公司	分公司
走八字	背字儿
走背运	走八字
走出去	请进来
走读生	寄宿生
走红运	背字儿
走神儿	凝神
走时运	背字儿
嘴啃泥	仰八叉
做长工	打短儿
做短工	打长工
做活儿	喘气
 
 
矮个子	高个子
爱国者	卖国贼
暗地里	明面上
凹面镜	凸面镜
凹透镜	凸透镜
白花花	白茫茫
白晃晃	白茫茫
白脸儿	黑脸儿
白茫茫	黑忽忽
百链钢	绕指柔
败家子	守财奴
傍黑儿	傍亮儿
傍亮儿	傍黑儿
褒义词	贬义词
暴发户	破落户
北半球	南半球
北方人	南方人
北寒带	南寒带
北极光	南极光
北极圈	南极圈
北温带	南温带
背风面	迎风面
背风坡	迎风坡
背光性	向光性
被害人	加害人
本地货	舶来品
本国货	来路货
必然性	偶然性
必修科	选修科
必需品	奢侈品
闭卷考	开卷考
闭幕式	开幕式
贬义词	褒义词
蹩脚货	珍贵品
剥削者	劳动者
舶来品	洋货
薄湿湿	暖烘烘
不安分	守分
不伏手	伏手
不高兴	高兴
不结实	牢固
不雅观	雅观
不值得	值得
布纹纸	光面相片
参战国	交战国
唱主角	跑龙套
抄近儿	绕远儿
扯後腿	破坏
沉甸甸	轻飘飘
持久战	速决战
臭烘烘	香喷喷
出发点	目的地
出笼鸟	辕下驹
出售品	非卖品
出柙虎	脱�马
处之袒	心安理得
寸草心	三春晖
大老婆	小老婆
大杂烩	清一色
单纯词	合成词
单记法	连记法
淡水湖	咸水湖
淡水鱼	咸水鱼
当事人	局外人
低能儿	高材生
低气压	高气压
低血压	高血压
喋不休	滔滔不绝
东半球	西半球
独立国	附庸国
独木桥	阳关道
独幕剧	多幕剧
对不起	对得起
对得起	对不起
顿开名	一窍不通
多幕剧	独幕剧
多年生	一年生
多元论	一元论
发话器	受话器
法律审	事实审
反比例	正比例
反对者	同盟者
反射角	投射角
反射线	入射线
非法性	合法性
附庸国	殖民地
富家儿	窭人子
戆小子	精灵鬼
高气压	低气压
高气压	低气压
高血压	低血压
搁不住	搁得住
搁不住	搁得住
搁得住	搁不住
格律诗	自由诗
共和国	君主国
好日子	苦日子
好一阵	一会儿
红彤彤	黑黝黝
积极性	消极性
