百尺竿头，更进一步	不求有功，但求无过
百读不厌，呼之欲出	枯燥无味
冰冻三尺，非一日之寒	浅尝辄止
兵来将挡，水来土掩	束手无策
不管三七二十一	丁是丁，卯是卯
不经一事，不长一智	痴学不悟顽固不化
不求有功，但求无过	百尺竿头，更进一步
不入虎穴，焉得虎子	胆小如鼠
不识庐山真面目，只缘身在此山中	不畏浮云速望眼，只缘身在最高层
不是冤家不聚头	千里姻缘一线牵
不为五斗米折腰	摧眉折腰事权责
不畏浮云遮望眼，只缘身在最高层	不识庐山真面目，只缘身在此山中
不问青红皂白	泾渭分明
不以成败论英雄	成则为王，败则为寇
不以一眚掩大德	攻其一点不及其余
裁兵，裁军	扩军
长江后浪推前浪	一代不如一代
车如流水马如龙	门前冷落鞍马稀
成则为王，败则为贼	不以成败论英雄
吃一堑，长一智	重蹈覆辙
初生牛犊不怕虎	胆小怕事
初生之犊不怕虎	不敢越雷池一步
船到江心补漏迟	亡羊补牢犹未晚
摧眉折腰事权责	不为五斗米折腰
打开窗户说亮话	指着和尚骂贼秃
打开天窗说亮话	指着和尚骂贼秃
打破沙锅问到底	一知半解
大处着眼，小处着墨	捡了芝麻，丢了西瓜
大处着眼，小处着手	捡了芝麻，丢了西瓜
大旱望云霓	久旱逢甘雨
道不同不相为谋	志同道合
得胜的猫儿欢似虎	落地的凤凰不如鸡
丁是丁，卯是卯	藕断丝连
斗筲之材（才)	大方之家
独树不成林	聚沙成塔
恶事传千里	好事不出门
耳闻不如目见	道听途说
放下屠刀，立地成佛	死不改悔
富贵不能淫	见利忘义
隔山观虎斗	扶危济困
攻其一点，不及其余	不以一眚掩大德
海内存知己，天涯若比	割席分座
好事不出门	恶事传千里
何乐而不为	迫不得已
捡了芝麻，丢了西瓜	大处着眼，小处着手
金无足赤，人无完人	十全十美
九牛二虎之力	举手投足
久旱逢甘雨	大旱望云霓
拒人于千里之外	平易近人
君子一言，快马一鞭	言而无信
君子之交淡如水	小人之交甘若醴
老当益壮，老马嘶风	未老先衰
历史唯物主义	历史唯心主义
历史唯心主义	历史唯物主义
立于不败之地	屡战屡败
庐山真面目	改头换面
落地的凤凰不如鸡	得胜的猫儿欢似虎
满招损，谦受益	刚愎自用
名不见经传	名垂后世
宁为玉碎，不为瓦全	忍气吞声
千里姻缘一线牵	不是冤家不聚头
千里之行，始于足下	好高骛远
前怕狼，后怕虎	胆大妄为
强不知以为知	知之为知之，不知为不知
巧妇难为无米之炊	指雁为羹
青出于蓝而胜于蓝	一代不如一代
群起而攻之	交口称赞
仁者见仁，智者见智	异口同声
三十六策，走为上策	坐以待毙
三十六计，走为上计	坐以待毙
三天打鱼，两天晒网	锲而不舍
杀人不见血	与人为善
失节变节再醮	守节
水火不相容	水乳交融
四体不勤，五谷不分	不辞辛劳孜孜不倦
天经地义大气	大谬不然
天经地义大气	大谬不然
天经地义大气	小气
天网恢恢，疏而不漏	逍遥法外
亡羊补牢犹未晚	船到江心补漏迟
无机可乘〔无隙可乘	有机可乘
狭小窄小苛严	镇压
想方设法，用尽心机	无所用心
小人之交甘若醴	君子之交淡如水
心有灵犀一点通	格格不入
心有余而力不足	行有余力
养军千日，用在一时	养痈贻患
一寸光阴一寸金	蹉跎岁月
一去不复返	反复无常
一人传虚，万人传实	百炼成钢
一言既出，驷马难追	言而无信
以眼还眼，以牙还牙	退避三舍
愚者千虑，必有一得	必有一失智者千虑
元（原）配	傍妻
造端，肇端	结局
知之为知之，不知为不知	强不知以为知
指着和尚骂贼秃	打开天窗说亮话
智者千虑，必有一失	愚者千虑
最大公约数	最小公倍数
最小公倍数	最大公约数
冰炭不同器	并容不悖
不敢越雷池一步	百无禁忌
不可同年而语	半斤八两
不可同日而语	半斤八两
不可望其项背	半斤八两
不可以道里计	半斤八两
尺有所短，寸有所长	一俊掩百丑
斥��闻欺大鸟	燕雀安知鸿鹄志
雏凤清于老凤声	一蟹不如一蟹
春江花月夜	月黑雁飞高
摧眉折腰事权贵	不为五斗米折腰
恶事行千里	好事不出门
费九牛二虎之力	不费吹灰之力
敢把皇帝拉下马	不敢越雷池一步
光杆儿司令	百万雄师
国人皆曰可杀	百身何赎
快刀断乱麻	带水拖泥
快刀斩乱麻	带水拖泥
落配的凤凰不如鸡	得胜的猫儿欢似虎
门前冷落鞍马稀	车如流水马如龙
门前冷落车马稀	车如流水马如龙
门庭冷落车马稀	车如流水马如龙
墙倒众人推	拔刀相助
人人得而诛之	百身何赎
忍恨吞声令	据理力争
山峰山膏山梁山头	河谷
舍得一身剐，敢把皇帝拉下马	不敢越雷池一步
深悄情厚意	没仁没义
十八层地狱	极乐世界
水尽山穷个	花明柳暗
太岁头上动土	不敢越雷池一步
天不怕，地不怕	不敢越雷池一步
天生我材必有用	百无一用
跳不出如来佛手掌心	鞭长莫及
同心闻同德	方底圆盖
惘然有失�	安闲自在
无可无不可	板上钉钉
无所措手足	措置裕如
相差十万八千里	八九不离十
行之非艰，知之惟艰	非知之难，行之惟艰
眼观六路，耳听八方	闭目塞听
燕雀安知鸿鹄志	斥�每闻欺大鸟
一不做，二不休	半途而废
一个心眼儿	半心半意
一好百好，一丑百丑	尺有所短，寸有所长
衣来伸手，饭来张口	筚路蓝缕
用佛再烧香	兵马未动，粮草先行
有眼不识泰山	别具只眼
愚者千虑，或有一得	智者千虑，必有一失
愚者千虑，亦有一得	智者千虑，必有一失
月黑雁飞高	春江花月夜
沾衣不湿杏花雨	暴雨倾盆
照葫芦画瓢	拔新领异
争名于朝，争利于市	不求有功，但求无过
智者千虑,必有一失	愚者千虑，必有一得
种豆得豆，种瓜得瓜	白费力气
 
 
 
 
